u f f f w e e w f f f u w
x w w w w w w w w w b x w
j g g g g g g g g g g j g
g g g g g g g g g g g g g
g g g g g g g g g g g g g
g g g g g g g g g g g g g
g g g g g g g g g g g g g
g g g g g g g g g g g g g
g g g g g g g g g g g g g
g g g g g g g g g g g g g